##I###..
#X...#.#
#.#.#...
II..#.E.
##I##I##
